###############
  #       #   #
# # ##### # # #
#   #     # # #
##### ####### #
#   # #   #   #
# # # # # # # #
# #     #   #  
###############
