###############
E #       #   #
# # ##### # # #
#   #     # # #
##### ####### #
#   # #   #   #
# # # # # # # #
# #     #   # S
###############
